1 1 1 1 1 1 1 A B 1 1 1 1 1 1 1
1 1 1 1 1 1 1 C D 1 1 1 1 1 1 1
1 1 1 1 1 1 1 1 1 1 1 1 1 1 1 1
1 1 1 1 1 1 1 1 1 1 1 1 1 1 1 1
1 1 1 ^ 1 1 1 1 1 1 1 1 1 1 1 1
1 1 1 1 1 1 1 2 2 1 2 1 1 1 1 1
1 1 1 1 1 1 1 1 1 1 2 2 1 1 1 1
1 1 1 1 1 1 1 1 1 1 1 1 1 1 1 1
1 1 1 1 1 1 1 2 2 1 1 1 1 1 1 1
1 1 1 1 1 1 1 1 2 1 1 1 1 1 1 1
1 1 1 1 1 1 1 1 1 1 1 1 1 1 1 1

tl - - - - - - 0 0 - - - - - - -
|. \ 4 4 4 4 4 0 E 4 4 4 4 4 4 4
|. 4 S 0 S 0 0 0 0 0 0 0 0 0 0 0
|. 4 S ^ S 0 0 0 0 0 0 0 0 0 0 0
|. 4 S 0 S 0 0 0 0 0 0 0 0 0 0 0
|. 4 0 0 0 0 0 0 0 0 0 0 0 0 0 0
|. 4 0 0 0 0 0 0 0 0 0 0 0 0 0 0
|. 4 0 0 0 0 0 0 0 0 0 0 0 0 0 0
|. 4 0 0 0 0 0 0 0 0 0 0 0 0 0 0
|. / 4 4 4 4 4 4 4 4 4 4 4 4 4 4
L _ _ _ _ _ _ _ _ _ _ _ _ _ _ _

0 0 0 # 0 0 0 0 0 0 0 0 0 0 0 0
0 0 0 # 0 0 0 0 0 0 0 0 0 0 0 0
0 0 S ^ S 0 0 0 0 0 0 0 0 0 0 0
0 0 S 0 S 0 0 0 0 0 0 0 0 0 0 0
0 0 S 0 S 0 0 0 0 0 0 0 0 0 0 0
0 0 0 0 0 0 0 0 0 0 0 0 0 0 0 0
0 0 0 0 0 0 0 0 0 0 0 0 0 0 0 0
0 0 0 0 0 0 0 0 0 0 0 0 0 0 0 0
0 0 0 0 0 0 0 0 0 0 0 0 0 0 0 0
0 0 0 0 0 0 0 0 0 0 0 0 0 0 0 0
0 0 0 0 0 0 0 0 0 0 0 0 0 0 0 0

0 0 0 0 0 0 0 0 0 0 0 0 0 0 0 0
0 0 0 0 0 0 0 0 0 0 0 0 0 0 0 0
0 0 S 0 S 0 0 0 0 0 0 0 0 0 0 0
0 0 S 0 S 0 0 0 0 0 0 0 0 0 0 0
0 0 0 0 0 0 0 0 0 0 0 0 0 0 0 0
0 0 0 0 0 0 0 0 0 0 0 0 0 0 0 0
0 0 0 0 0 0 0 0 0 0 0 0 0 0 0 0
0 0 0 0 0 0 0 0 0 0 0 0 0 0 0 0
0 0 0 0 0 0 0 0 0 0 0 0 0 0 0 0
0 0 0 0 0 0 0 0 0 0 0 0 0 0 0 0
0 0 0 0 0 0 0 0 0 0 0 0 0 0 0 0