1 1 1 1 1 1 1 1 1 1 1 1 1 1 1 1
1 1 1 1 1 1 1 1 1 1 1 1 1 1 1 1
1 1 1 1 1 1 1 1 1 1 1 1 1 1 1 1
1 1 1 1 1 1 1 1 1 1 1 1 1 1 1 1
1 1 1 ^ 1 1 1 1 1 1 1 1 1 1 1 1
1 1 1 1 1 1 1 1 1 1 1 1 1 1 1 1
1 1 1 1 1 1 1 1 1 1 1 1 1 1 1 1
1 1 1 1 1 1 1 1 1 1 1 1 1 1 1 1
1 1 1 1 1 1 1 1 1 1 1 1 1 1 1 1
1 1 1 1 1 1 1 1 1 1 1 1 1 1 1 1
1 1 1 1 1 1 1 1 1 1 1 1 1 1 1 1

tl - - - - - - A B - - - - - - -
|. \ 4 4 4 4 4 C D 4 4 4 4 4 4 4
|. 4 0 0 0 0 0 0 0 0 0 0 0 0 0 0
|. 4 0 ^ 0 0 0 0 0 0 0 0 0 0 0 0
|. 4 0 0 0 0 0 0 2 0 0 0 0 0 0 0
|. 4 0 0 2 0 0 0 2 2 0 0 0 0 0 0
|. 4 0 2 2 2 0 0 0 0 0 0 2 0 0 0
|. 4 0 0 0 0 0 0 2 0 0 0 2 0 0 0
|. 4 0 2 2 2 0 0 0 0 0 0 2 0 0 0
|. / 4 4 4 4 4 4 4 4 4 4 4 4 4 4
L _ _ _ _ _ _ _ _ _ _ _ _ _ _ _

0 0 0 # 0 0 0 0 0 0 0 0 0 0 0 0
0 0 0 # 0 0 0 0 0 0 0 0 0 0 0 0
0 0 0 ^ 0 0 0 0 0 0 0 0 0 0 0 0
0 0 0 0 0 0 0 0 0 0 0 0 0 0 0 0
0 0 0 0 0 0 0 0 0 0 0 0 0 0 0 0
0 0 0 0 0 0 0 0 0 0 0 0 0 0 0 0
0 0 0 0 0 0 0 0 0 0 0 0 0 0 0 0
0 0 0 0 0 0 0 0 0 0 0 0 0 0 0 0
0 0 0 0 0 0 0 0 0 0 0 0 0 0 0 0
0 0 0 0 0 0 0 0 0 0 0 0 0 0 0 0
0 0 0 0 0 0 0 0 0 0 0 0 0 0 0 0