1 1 1 1 1 1 1 1 1 1 1 1 1 1 1 1
1 1 1 1 1 1 1 1 1 1 1 1 1 1 1 1
1 1 1 1 1 1 1 1 1 1 1 1 1 1 1 1
1 1 1 1 1 1 1 1 1 1 1 1 1 1 1 1
1 1 1 1 1 1 1 1 1 1 1 1 1 1 1 1
1 1 v 1 1 1 1 1 1 1 1 1 v 1 1 1
1 1 1 1 1 1 1 1 1 1 1 1 1 1 1 1
1 1 1 1 1 1 1 1 1 1 1 1 1 1 1 1
1 1 1 1 1 1 1 1 1 1 1 1 1 1 1 1
1 1 1 1 1 1 1 1 1 1 1 1 1 1 1 1
1 1 1 1 1 1 1 1 1 1 1 1 1 1 1 1

tp - - - - - - - - - - - - - - -
|. \ 4 4 4 4 4 4 4 4 4 4 4 4 4 4
|. 4 0 0 0 0 0 0 0 0 0 0 0 0 0 0
|. 4 0 0 0 0 0 0 0 0 0 0 0 0 0 0
|. 4 0 0 0 0 0 S S 0 0 0 0 0 0 0
|. 4 0 0 0 0 0 S S 0 0 0 0 0 0 0
|. 4 v 0 0 0 0 0 0 0 0 0 v 0 0 0
|. 4 0 0 0 0 0 0 0 0 0 0 0 0 0 0
|. 4 0 0 0 0 0 0 0 0 0 0 0 0 0 0
|. / 4 4 4 4 4 0 0 4 4 4 4 4 4 4
L _ _ _ _ _ _ 0 0 _ _ _ _ _ _ _

0 0 0 0 0 0 0 0 0 0 0 0 0 0 0 0
0 0 0 0 0 0 0 0 0 0 0 0 0 0 0 0
0 0 0 0 0 0 0 0 0 0 0 0 0 0 0 0
0 0 0 0 0 0 0 0 0 0 0 0 0 0 0 0
0 0 0 0 0 0 0 0 0 0 0 0 0 0 0 0
0 0 0 0 0 0 0 0 0 0 0 0 0 0 0 0
0 0 0 0 0 0 0 0 0 0 0 0 0 0 0 0
0 0 v 0 0 0 0 0 0 0 0 0 v 0 0 0
0 0 # # # # # # # # # # # 0 0 0
0 0 0 # 0 0 0 0 0 0 0 0 0 0 0 0
0 0 0 # 0 0 0 0 0 0 0 0 0 0 0 0