1 1 1 1 1 1 A B 1 1 1 1 1 1 1 1
1 1 1 1 1 1 C D 1 1 1 1 1 1 1 1
1 1 1 1 1 1 1 1 1 1 1 1 1 1 1 1
1 1 1 1 1 1 1 1 1 1 1 1 1 1 1 1
1 1 1 1 1 1 1 1 1 1 1 1 ^ 1 1 1
1 1 1 1 1 1 1 1 1 1 1 1 1 1 1 1
1 1 1 1 1 1 1 1 1 1 1 1 1 1 1 1
1 1 1 1 1 1 1 1 1 1 1 1 3 3 3 3
1 1 1 1 1 1 1 1 1 1 1 1 3 3 3 3
1 1 1 1 1 1 1 1 1 1 1 1 1 1 1 1
1 1 1 1 1 1 1 1 1 1 1 1 1 1 1 1

- - - - - - 0 0 - - - - - - - tr
4 4 4 4 4 4 0 E 4 4 4 4 4 4 / .|
0 0 0 0 0 0 0 0 0 0 0 S 0 S 4 .|
0 0 0 0 0 0 0 0 0 0 0 S ^ S 4 .|
0 0 0 0 0 0 0 0 0 0 0 S 0 S 4 .|
0 0 0 0 0 0 0 0 0 0 0 0 0 0 4 .|
0 0 0 0 0 0 0 0 0 0 0 0 0 0 4 .|
0 0 0 0 0 0 0 0 0 0 0 0 0 0 0 0
0 0 0 0 0 0 0 0 0 0 0 0 0 0 0 0
4 4 4 4 4 4 4 4 4 4 4 4 4 4 \ .|
_ _ _ _ _ _ _ _ _ _ _ _ _ _ _ br

0 0 0 0 0 0 0 0 0 0 0 0 # 0 0 0
0 0 0 0 0 0 0 0 0 0 0 0 # # # #
0 0 0 0 0 0 0 0 0 0 0 S ^ S 0 0
0 0 0 0 0 0 0 0 0 0 0 S 0 S 0 0
0 0 0 0 0 0 0 0 0 0 0 S 0 S 0 0
0 0 0 0 0 0 0 0 0 0 0 0 0 0 0 0
0 0 0 0 0 0 0 0 0 0 0 0 0 0 0 0
0 0 0 0 0 0 0 0 0 0 0 0 0 0 0 0
0 0 0 0 0 0 0 0 0 0 0 0 0 0 0 0
0 0 0 0 0 0 0 0 0 0 0 0 0 0 0 0
0 0 0 0 0 0 0 0 0 0 0 0 0 0 0 0

0 0 0 0 0 0 0 0 0 0 0 0 0 0 0 0
0 0 0 0 0 0 0 0 0 0 0 0 0 0 0 0
0 0 0 0 0 0 0 0 0 0 0 S 0 S 0 0
0 0 0 0 0 0 0 0 0 0 0 S 0 S 0 0
0 0 0 0 0 0 0 0 0 0 0 0 0 0 0 0
0 0 0 0 0 0 0 0 0 0 0 0 0 0 0 0
0 0 0 0 0 0 0 0 0 0 0 0 0 0 0 0
0 0 0 0 0 0 0 0 0 0 0 0 0 0 0 0
0 0 0 0 0 0 0 0 0 0 0 0 0 0 0 0
0 0 0 0 0 0 0 0 0 0 0 0 0 0 0 0
0 0 0 0 0 0 0 0 0 0 0 0 0 0 0 0