1 1 1 1 1 1 1 1 1 1 1 1 1 1 1 1
1 1 1 1 1 1 1 1 1 1 1 1 1 1 1 1
1 1 1 1 1 1 1 1 1 1 1 1 1 1 1 1
1 1 1 1 1 1 1 1 1 1 1 1 1 1 1 1
1 1 1 1 1 1 1 1 1 1 1 1 1 1 1 1
1 1 v 1 1 1 1 1 1 1 1 1 v 1 1 1
1 1 1 1 1 1 1 1 1 1 1 1 1 1 1 1
1 1 1 1 1 1 1 1 1 1 1 1 1 1 1 1
1 1 1 1 1 1 1 1 1 1 1 1 1 1 1 1
1 1 1 1 1 1 1 1 1 1 1 1 1 1 1 1
1 1 1 1 1 1 1 1 1 1 1 1 1 1 1 1

tl - - - - - - - - - - - - - - -
|. \ 4 4 4 4 4 4 4 4 4 4 4 4 4 4
|. 4 0 0 0 0 0 0 0 0 0 0 0 0 0 0
|. 4 0 0 0 0 0 0 0 0 0 0 0 0 0 0
|. 4 0 0 0 0 0 S S 0 0 0 0 0 0 0
|. 4 0 S 0 0 0 S S 0 0 S 0 S 0 0
|. 4 v S 0 0 0 0 0 0 0 S v S 0 0
|. 4 S S 0 0 0 0 0 0 0 S S S 0 0
|. 4 0 0 0 0 0 0 0 0 0 0 0 0 0 0
|. / 4 4 4 4 4 0 0 4 4 4 4 4 4 4
L _ _ _ _ _ _ 0 0 _ _ _ _ _ _ _

0 0 0 0 0 0 0 0 0 0 0 0 0 0 0 0
0 0 0 0 0 0 0 0 0 0 0 0 0 0 0 0
0 0 0 0 0 0 0 0 0 0 0 0 0 0 0 0
0 0 0 0 0 0 0 0 0 0 0 0 0 0 0 0
0 0 0 0 0 0 0 0 0 0 0 0 0 0 0 0
0 0 0 0 0 0 0 0 0 0 0 0 0 0 0 0
0 0 0 S 0 0 0 0 0 0 0 S 0 S 0 0
0 0 v S 0 0 0 0 0 0 0 S v S 0 0
0 0 # # # # # # # # # # # 0 0 0
0 0 0 # 0 0 0 0 0 0 0 0 0 0 0 0
0 0 0 # 0 0 0 0 0 0 0 0 0 0 0 0

0 0 0 0 0 0 0 0 0 0 0 0 0 0 0 0
0 0 0 0 0 0 0 0 0 0 0 0 0 0 0 0
0 0 0 0 0 0 0 0 0 0 0 0 0 0 0 0
0 0 0 0 0 0 0 0 0 0 0 0 0 0 0 0
0 0 0 0 0 0 0 0 0 0 0 0 0 0 0 0
0 0 0 0 0 0 0 0 0 0 0 0 0 0 0 0
0 0 0 0 0 0 0 0 0 0 0 0 0 0 0 0
0 0 0 S 0 0 0 0 0 0 0 S 0 S 0 0
0 0 0 0 0 0 0 0 0 0 0 0 0 0 0 0
0 0 0 0 0 0 0 0 0 0 0 0 0 0 0 0
0 0 0 0 0 0 0 0 0 0 0 0 0 0 0 0