1 1 1 1 1 1 1 1 1 1 1 1 1 1 1 1
1 1 1 1 1 1 1 1 1 1 1 1 1 1 1 1
1 1 1 1 1 1 1 1 1 1 1 1 1 1 1 1
1 1 1 1 1 1 2 1 2 1 1 1 1 1 1 1
1 1 1 1 1 1 1 1 1 1 1 1 1 1 1 1
1 1 1 1 1 1 1 1 1 1 1 1 1 1 1 1
1 1 1 1 1 2 1 1 1 1 1 1 1 1 1 1
1 1 1 1 1 1 1 1 1 1 1 1 1 1 1 1
1 1 1 1 1 1 1 1 1 1 1 1 1 1 1 1
1 1 1 1 1 1 1 1 1 1 1 1 1 1 1 1
1 1 1 1 1 1 1 1 1 1 1 1 1 1 1 1

- - - - - - - - - - - - - - - tr
4 4 4 4 4 4 4 4 4 4 4 4 4 4 / .|
0 0 0 0 0 0 0 0 0 0 0 0 0 0 4 .|
0 0 0 0 0 0 0 0 0 0 0 0 0 0 4 .|
0 0 0 0 0 0 0 0 0 0 0 0 0 0 4 .|
0 0 0 0 0 0 0 0 0 0 0 0 0 0 4 .|
0 0 0 0 0 0 0 0 0 0 0 0 0 0 4 .|
0 0 0 0 0 0 0 0 0 0 0 0 0 0 4 .|
0 0 0 0 0 0 0 0 0 0 0 0 0 0 4 .|
4 4 4 4 4 4 0 0 4 4 4 4 4 4 \ .|
_ _ _ _ _ _ 0 0 _ _ _ _ _ _ _ .|

0 0 0 0 0 0 0 0 0 0 0 0 0 0 0 0
0 0 0 0 0 0 0 0 0 0 0 0 0 0 0 0
0 0 0 0 0 0 0 0 0 0 0 0 0 0 0 0
0 0 0 0 0 0 0 0 0 0 0 0 0 0 0 0
0 0 0 0 0 0 0 0 0 0 0 0 0 0 0 0
0 0 0 0 0 0 0 0 0 0 0 0 0 0 0 0
0 0 0 0 0 0 0 0 0 0 0 0 0 0 0 0
0 0 0 0 0 0 0 0 0 0 0 0 0 0 0 0
# # # # # # # # # # # # # 0 0 0
0 0 0 0 0 0 0 0 0 0 0 0 # 0 0 0
0 0 0 0 0 0 0 0 0 0 0 0 # 0 0 0